.........#...#......
.#.#....#.#....#....
...#..#.#.....#.....
.#.#..##.##....#..##
........#.#......#..
.....#....###.##..#.
..#.....##.##...##.#
...##....#.#.#.#S#..
....#E.#.......#.#.#
#......#.....##.....
